111111
000100
101101
101001
100001
101101
101101
111111