111111111111111
100000001000001
101110101010111
000010101010001
111110111011101
100010000010001
101011111110111
101010000010001
101011101011101
101000001010101
101110111010101
000000001000101
111111111111111